80 544 9 5 5 5 5 5 5 5 5 5 5 5 5 5 5 5 5 5 5 5 5 5 5 5 5 5 5 5 5 5 5 5 5 5 5 5 5 5 5 5 5 5 5 5 5 5 5 5 5 8
17 0 0 0 0 0 0 0 0 0 0 0 1 0 0 0 1 1 0 1 0 1 0 1 0 0 1 0 1 0 0 0 0 0 0 0 0 0 0 0 0 0 0 0 0 0 0 0 0 17
17 0 0 0 0 0 0 0 0 0 0 0 1 0 0 0 1 1 0 1 0 1 0 1 0 0 1 0 1 0 0 0 0 0 0 0 0 0 0 0 0 0 0 0 0 0 0 0 0 17
17 0 0 0 0 0 0 0 0 0 0 0 1 0 0 0 1 1 0 1 0 1 0 1 0 0 1 0 1 0 0 0 0 0 0 0 0 0 0 0 0 0 0 0 0 0 0 0 0 17
17 0 0 0 0 0 0 0 0 0 0 0 1 0 0 0 1 10 3 7 0 1 0 10 3 3 7 0 1 0 0 0 0 0 0 0 0 0 0 0 0 0 0 0 0 0 0 0 0 17
17 0 0 0 0 0 0 0 0 0 0 0 10 7 0 0 1 9 5 8 0 1 0 9 5 5 8 0 1 0 0 0 0 0 0 0 0 0 0 0 0 0 0 0 0 0 0 0 0 17
17 0 0 0 0 0 0 0 0 0 0 0 6 4 0 0 1 0 0 0 0 1 0 0 0 0 0 0 1 0 0 0 0 0 0 0 0 0 0 0 0 0 0 0 0 0 0 0 0 17
17 0 0 0 0 0 0 0 0 0 0 0 6 4 0 0 1 0 0 0 0 1 0 0 0 0 0 0 1 0 0 0 0 0 0 0 0 0 0 0 0 0 0 0 0 0 0 0 0 17
17 0 0 0 0 0 0 0 0 0 0 0 6 4 0 0 1 0 0 0 0 1 0 0 0 0 0 0 1 0 0 0 13 13 0 0 0 0 0 0 0 0 0 0 0 0 0 0 0 17
17 0 0 0 0 0 0 0 0 0 0 0 6 11 3 3 7 0 0 0 0 1 0 0 0 0 0 0 1 0 0 0 10 7 0 0 0 0 0 0 0 0 0 0 0 0 0 0 0 17
17 0 0 0 0 0 0 0 0 0 0 0 9 5 5 5 8 0 0 0 0 1 0 0 0 0 0 0 1 0 0 0 6 4 0 0 0 0 0 0 0 0 0 0 0 0 0 0 0 17
17 0 0 0 0 0 0 0 0 0 0 0 0 0 0 0 0 0 0 0 0 10 3 3 3 3 3 3 7 0 0 0 6 4 0 0 0 0 0 0 0 0 0 0 0 0 0 0 0 17
17 0 0 0 0 0 0 0 0 0 0 0 0 0 0 0 0 0 0 0 0 9 5 5 5 5 5 5 8 0 0 0 6 4 0 0 0 0 0 0 0 0 0 0 0 0 0 0 0 17
17 0 0 0 0 0 0 10 3 7 0 0 0 0 0 0 0 0 0 0 0 0 0 0 0 0 0 0 0 0 0 0 6 4 0 0 0 0 0 0 0 0 0 0 0 0 0 0 0 17
17 0 0 0 0 0 0 6 2 4 0 0 0 0 0 0 0 0 0 0 0 0 0 0 0 0 0 0 0 0 0 0 6 4 0 0 0 0 0 0 0 0 0 0 0 0 0 0 0 17
17 0 0 0 10 3 3 12 2 4 0 0 0 0 0 0 0 0 0 0 0 10 7 0 0 0 0 10 7 0 0 0 6 11 3 3 3 7 0 0 0 0 0 0 0 0 0 0 15 16
17 0 0 0 6 2 2 2 2 4 13 13 0 0 0 0 0 0 0 0 0 6 4 13 13 13 13 6 4 0 0 0 6 2 2 2 2 4 0 0 0 0 0 0 0 0 0 0 6 4
10 3 3 3 12 2 2 2 2 11 3 3 3 3 7 0 0 0 10 3 3 12 11 3 3 3 3 12 11 3 3 3 12 2 2 2 2 11 3 3 3 3 3 3 3 3 3 3 12 4
6 2 2 2 2 2 2 2 2 2 2 2 2 2 4 18 18 18 6 2 2 2 2 2 2 2 2 2 2 2 2 2 2 2 2 2 2 2 2 2 2 2 2 2 2 2 2 2 2 4
